ДСД ІЦІ ЕЦОАФЦІ

Зсув Цезаря: -5

Таблиця замін:
А: Ц
Б: У
В: Н
Г: Є
Д: Ю
Е: Х
Є: Я
Ж: Т
З: І
И: Д
І: Ь
Ї: К
Й: С
К: Ж
Л: Ф
М: З
Н: Щ
О: А
П: И
Р: Г
С: Й
Т: Е
У: Л
Ф: В
Х: М
Ц: Ї
Ч: П
Ш: Ш
Щ: О
Ь: Ч
Ю: Б
Я: Р
